000000000000000000000000000000000000000000000000000000000
000000000000000000000000000000000000000000000000000000000
000000000000000000000000000000000000000000000000000000000
000000000000000000000000000000000000000000000000000000000
000000000000000000000000000000000000000000000000000000000
000000111111111110000000000000000000000000000000000000000
000000000000001010000000000000000000000000000000000000000
000000000000001010000000000000000000000000000000000000000
000000000000001010000000000001111111100000000000000000000
000000000000001010000000000001000000000000000000000000000
000000000000001010000000000001000000000000000000000000000
000000000000001010000000000001000000000000000000000000000
000000000000000000000000000000000000000000000000000000000
000000000000000000000000000000000000000000000000000000000
000000000000000000000000000000000000000000000000000000000
000000000000000000000000000000000000000000000000000000000
000000000000000000010000000000000000000000000000000000000
111111111111111111111111111111111111111111111110000000000
111111111111111111111111111111111111110000000000000000000
111111111111111111111111111100000000000000000000000000000
111111111111111111111100000000000000000000000000000000000
111111111111111000000000000000000000000000000000000000000
111110000000000000000000000000000000000000000000000000000
000000000000000000000000000000000000000000000000000000000
000000000000000000000000000000000000000000000000000000000
000000000000000000000000000000000000000000000000000000000
000000000000000000000000000000000000000000000000000000000
000000000000000000000000000000000000000000000000000000000
000000000000000000000000000000000000000000000000000000000
000000000000000000000000000000000000000000000000000000000
000000000000000000000000000000000000000000000000000000000
000000000000000000000000000000000000000000000000000000000
000000000000000000000000000000000000000000000000000000000
000000000000000000000000000000000000000000000000000000000
111111111111111111110000000000000000000000000000000000000
111111111111111111111111111110000000000000000000000000000
111111111111111111111111111111111111111111111111111100000
000000000000000000000000000000000000000000000000000000000